111111111111111
1E0CM000C0000C1
100000C0000P001
1111111111C1111
1000000C0000001
1000C0000C000C1
10000000M000001
111111111111111