111111111111111
1E0CM000C0000P1
1C0000111111111
111111111111111