1111111111111111111
1E0C00000000000C001
100000000000000P001
1111101101111111111
1C0000C0000C0000001
1111111111111111111