1111111111111111111
1E0C00000000000C001
1000000000M0000P001
11111M1101111111111
1C0000C0000C0M00001
1111111111111111111