111111111111111
1E0C0000C0000P1
1C00C0111111111
111111111111111