111111111111111
1E0CM000C0000P1
1C000000000M011
1000MC000011001
1C0000000000001
111110C1C111111
100000000000001
111111111111111
